Yo quiro comprar ropa, cuándo es bueno en frío y calor. Además es bueno en agua.
Acá tengo despacio mi portátil sin electrici. Esto tiempo comere agua. Hambre puede ir con sed. Compro zumo y café y bebo y sed es despacio historia. 
Selva cansado trae dormir.


#Pot




- to, toto - eso,  esto
= nakoupit - comprar
- chladno - frío
- teplo - calor
- voda - agua -
= oblečení - ropa
- acá - here
- počasí - tiempo
- jíst - comer
- hlad - hambre
- žízeň - sed
- pití - beber
- džus - zumo
- pomalu - despacio
nemoc - enfermedad
- unavený - cansado
- děláš - haces


aburrido - boring
příběh - cuento, historia
rovník - ecuador
kalhoty - pantalones
šaty - vestido
mikina - sudadera
košile - camisa
- káva - café
půjčka - préstamo
půjčit - prestar
tamto - aquello
zlost - enfado
zlobit se - enfadarse
opravdu - realmente
komáři - mosquitos
komár - mosquito
moucha - mosca
chleba - pan
máslo - mantequilla
motivace - motivación
hovno - mierda
kurva - puta
čurák - polla
péro - polla
píča - coño
kreslit - dibujar
kráva - vaca
osel - burro
nemocný - enfermo
auto - coche
kolo - bicicleta
pěšky - a pie
pěšky - andando
hora - montaña
- džungle - selva
pokoj - habitación, cuarto, sala
- elektřina - electrici
liána - liana
rostliny - plantas
kytka - flor
strom - árbol
kmen - tronco
větev - rama
list - hoja
opice - mono
příšera - bicho
želva - tortuga
stěna - pared
zábava - Entretenimiento, diversión
smích - risa
smát se - reírse
cestující - pasajero
trapné - vergonzoso
pamatovat si - recordar
- laptop, notebook - #ordenador portátil, portátil, cuaderno
bolet - hongo
bolest - dolor
bolet - seta
když -  cuando
vědět - conoce, sé
znát - sabe
znám - conozco
plus - más
vydrží - dura
snese - aguanta
odolné -  resistente
letadlo - avión
vybitý - agotado
baterie - batería
doufám, snad - espero
přeju si - deseo
přát si - desear
aby - para
ale - pero
hladový - hambriento
hladovou -  hambrienta
minulost - pasado
se stal - se hizo
stát se - hacerse
růst - crecer
spánek - sueño
jednoduší - más fácil