100
hotový - xong
hezké - Đẹp
trochu - một chút
plný - no roi
nic - không gì cả
hodně - nhiều
horko - nhiệt
chladno - lạnh lẽo
pomalu - chậm
rychle - nhanh
možná - Có lẽ, Có thể
Česko - Cộng hòa Séc
chci - Tôi muốn
platit - chi trả
můžu - Tôi có thể
jíst - ăn
vědět - biết 
potřebovat - nhu cầu
potřebuji - Tôi cần
umět - để có thể
umim - tôi có thể
jít, jet - đi
mluvit - nói chuyện
auto - xe hơi
cesta - đường
hlad - đói
voda - Nước
jídlo - đồ ăn
bolet - đau
dnes - Hôm nay
zitra - Ngày mai
a - và
z - từ
na - trên
u - tại
v - trong
s - với
před - trước
nad - qua
pod - dưới
potom - sau đó
do - ĐẾN
ale - Nhưng
protože - bởi vì
aby - cái đó
on - Anh ta
ona - cô ấy
ono - Nó
my - chúng tôi
vy - Bạn
oni - họ
opilý - say rượu
ok - được rồi
+++++
kompletní - hoàn thành
nádherné - xinh đẹp
málo - nhỏ bé
příliš - cũng vậy
ne příliš mnoho - không quá nhiều
hloupé - ngốc nghếch
ošklivé, škaredé - xấu xí
hnus - sự ghê tởm
